# # # # # # # # # # # # # # # # # # 
# E E E A E E E A E E E E A E A E # 
# R E E E E A E E E E A E E E E E # 
# E E A E E E E E A E E E E A E E # 
# # # # # # # # # # # # # # # # E # 
# E E E A E E E A E E E E A E A E # 
# R E E E E A E E E E A E E E E E # 
# E E A E E E E E A E E E E A E E # 
# # # # # # # # # # # # # # # # # # 